+-------------------------------------------------------------------+
|                                                                   |
|                                                                   |
|                                                                   |
|                                                                   |
|                                                                   |
|                                                                   |
|                                                                   |
|                                                                   |
|                                                                   |
|                                                                   |
|                                                                   |
|                                                                   |
|                                                                   |
|                                                                   |
|                                                                   |
|                                                                   |
|                                                                   |
|                                                                   |
|                                                                   |
+-------------------------------------------------------------------+
level
+-------------------------------------------------------------------+
|                                                                   |
|                                                                   |
|                                                                   |
|         ------------------------------------------------          |
|                                                                   |
|                                                                   |
|                                                                   |
|                                                                   |
|                                                                   |
|         ------------------------------------------------          |
|                                                                   |
|                                                                   |
|                                                                   |
|                                                                   |
|                                                                   |
|         ------------------------------------------------          |
|                                                                   |
|                                                                   |
|                                                                   |
+-------------------------------------------------------------------+
level
+-------------------------------------------------------------------+
|                                                                   |
|                                                                   |
|                                                                   |
+----------------------------------------------------               |
|                                                                   |
|                                                                   |
|                     |                      |                      |
|                     |                      |                      |
|                     |                      |                      |
|                     |                      |                      |
|                     |                      |                      |
|                     |                      |                      |
|                     |                      |                      |
|                                                                   |
|                                                                   |
|           --------------------------------------------------------+
|                                                                   |
|                                                                   |
|                                                                   |
+-------------------------------------------------------------------+
level
+--------------------------------+----------------------------------+
|                                |                                  |
|                                |                                  |
|             |                  |                |                 |
|             |                  |                |                 |
|             |                  |                |                 |
|             |                  |                |                 |
|             |                  |                |                 |
|                                                                   |
|                                                                   |
+----------------------------         ------------------------------+
|                                                                   |
|                                                                   |
|             |                  |                |                 |
|             |                  |                |                 |
|             |                  |                |                 |
|             |                  |                |                 |
|             |                  |                |                 |
|                                |                                  |
|                                |                                  |
+--------------------------------+----------------------------------+
level
+++++++++++++++++++++----------------++++++++++++++++++++++++++++++++
+++++++++++++++++++++                ++++++++++++++++++++++++++++++++
++++++++        ++++                       ++++++++++++++++++++++++++
++++            ++++   ++++++++++++         ++++++++             ++++
++++      ++++  ++++   ++++++++++++++++++   ++++++++             ++++
++++  ++++++++  ++++   ++++++++++++++++++   ++++++++   +++++++   ++++
+++   ++++++++   +++     ++++++++++++++++   ++++++++   +++++++   ++++
+++   ++++++++    +++                                  +++++++   ++++
+++  ++++++++++   +++++                                +++++++   ++++
+++  +++++++++++  +++++++++++++++++++++++   ++++++++++++++++++   ++++
+++  +++++++++++  +++++++++++++++++++++++   ++++++++++++++++++   ++++
+++   ++++++++++  ++++++++++++++++++++++    ++++++++++           ++++
+++   ++++++++++    ++++++++++              ++++++++++           ++++
++++  ++++++++++                          ++++++++++++   ++++++++++++
++++     +++++++++              +---------++++++++++++   ++++++++++++
++++     +++++++++--------------+                        ++++++++++++
++++++   ++                                              ++++++++++++
+++++++                             +++++++++++++++++++++++++++++++++
+++++++      ++++++++++++++++++++++++++++++++++++++++++++++++++++++++
+++++++++++++++++++++++++++++++++++++++++++++++++++++++++++++++++++++
+++++++++++++++++++++++++++++++++++++++++++++++++++++++++++++++++++++
